R 1920 1080

NO texture/aot_no.xpm

SO texture/aot.xpm

WE texture/aot_no.xpm

EA texture/aot.xpm

S texture/eren.xpm

C 60,60,110

F 100,40,40

1111111111111111111111111
1000000000000000000000001
1000011111111111110000001
1000010000000000010000001
1000010000000000010000001
1000010002000200010000001
1000010000000000010000001
1000011111100111110000001
1000000000000000000000001
10000000000N0000000000001
1000000020000020000000001
1111111111111111111111111