R 1080 720

NO texture/brand.xpm

SO texture/faces.xpm

WE texture/faces.xpm

EA texture/brand.xpm

S texture/griffith.xpm

C 151,1,4

F 81,10,10

1111111111111111111111111
1000000000110000000000001
101100000111000020000001
10010000000000000000000011111111
111111011011000001110000000000001
100000000011000001110111111111111
11110101111111011100000000001
11110101111111011101010010001
11000000000101011100200010001
10002000200000001100000010001
10000000000000001101010010001
110000011101011111010111100111
11110111 111N101 101111000001
11111111 1111111 11111111111