R 1920 1080

NO texture/robot.xpm

SO texture/mario.xpm

WE texture/window.xpm

EA texture/geek.xpm

S texture/post.xpm

C 109,150,205

F 31,52,47

111111111111111111111111
100000011111111110000001
100000000000000000000001
100220000000000000022001
100000000222220000000001
100220000000000000022001
100000000222220000000001
100220000000000000022001
100000000000000000000001
10000000000N000000000001
111111111111111111111111