R 1920 1080

NO texture/chiseled_nether_bricks.xpm

SO texture/chiseled_nether_bricks.xpm

WE texture/nether_wart_block.xpm

EA texture/nether_bricks.xpm

S texture/truguts.xpm

C 100,0,0

F 199,10,30

1111111111111111111111111
1000000000110000000000001
101100000111000000000001
10010000000000000000000011111111
111111011011000001110000000000001
100000000011000001110111111111111
11110101111111011100000000001
11110101111111011101010010001
11000000000101011100000010001
10002000000000001100000010001
10000000000000001101010010001
110000011101011111010111100111
11110111 111N101 101111000001
11111111 1111111 11111111111