R 1920 1080

NO texture/blast_furnace_side.xpm

SO texture/blast_furnace_side.xpm

WE texture/blast_furnace_side.xpm

EA texture/blast_furnace_side.xpm

S texture/barrel.xpm
F 20,5,13
C 40,15,26

1111111111111111111111111
1000000000110000000000001
101100000111000002000001
10010000000000000000000011111111
111111011011000001110000000000001
100000000011000001110111111111111
11110101111111011100000000001
11110101111111011101010010001
11000000000101011100000010001
10002000N00000001100000010001
10000000000000001101010010001
110000011101011111010111100111
11110111 1110101 101111000001
11111111 1111111 11111111111