R 1080 800

NO texture/aot_no.xpm

SO texture/aot.xpm

WE texture/aot_no.xpm

EA texture/aot.xpm

S texture/eren.xpm

C 109,150,205

F 31,52,47

1111111111111111111111111  
1020000000000000000022001   
1000011111111111110000001
1000010000000000010000001
1002010020020000210002001    
1000010002002000010000001  
1000010000000000010000001
1000011111100111110000001
1020000000000000000000021               
10000202000N0002000200001
1000000000000000200000001
1111111111111111111111111              