R 1920 1080

NO texture/robot.xpm

SO texture/mario.xpm

WE texture/wall_cluster.xpm

EA texture/geek.xpm

S texture/post.xpm

F 190,190,190

C 79,79,79

111111111111111111111111
100000011111111110000001
100000000000000000000001
100220000000000000022001
100000000222220000000001
100220000000000000022001
100000000222220000000001
100220000000000000022001
100000000000000000000001
10000000000N000000000001
111111111111111111111111